######################################################################
#S     #   #       #   #       #       #     #     #         #       #
# ### ### ### ### ### ### ##### ### ### ##### ### ##### ### ### ##### #
# #   #   # # #   #   #     #     #   #     # # #   # #   #   #     # #
# # ### ### # ##### ### ### ### ### ##### ##### ### ### ### ##### ### #
# # #       #   #       #     #     #   # #   # #   # #   #       #   #
# # ### ### ### ### ### ##### # ### ##### ### # ### ### # ##### ##### #
# #     # #   #   # #     #   #     #   #   # #     # # #     #       #
# # ##### ### # ### ##### ### ##### ##### # ##### ### ##### ##### ### #
# # #   # #   #       #     #   #       # # # #   #       # #     #   #
### ### # # ##### ### ##### # ### ### ### ### ### ##### # # ##### ### #
# #   # # # #   # # # #   # # #   #   #     # # # #   # #   #   #     #
# # ### ### ### ### ### # # ### # ##### ##### # ### # ### ##### ### ###
# #   #       # #     # #   #   #     #     #   #   # # #     #   #   #
# ### ##### ##### ##### ### # ##### ### ##### ### ##### ### ### ##### #
# # #     #   #       #     # #     #     # #   #   #   #   #     #   #
# # ### ##### # ##### ### ### ##### ##### # ##### ### ### # ##### ### #
#   #   #   # #     #   # # #     #   # # #   #   #   #   # #   #   # #
# ##### # # # ### ##### # ### ### # # # ##### # ##### ### # ### ### # #
# #   #   # #   #   # #     # #   # #   #   # #   #   #   # # # #   # #
# # ### ### ##### ### ### ### ##### ### ##### ### # ### ##### # # ### #
#     #   #   #       #       # #   #       #   # #   # #     #   # # #
##### ### ##### ### # ##### # # # ### ##### ### ### ### # ##### ### # #
#     #       # #   # #     # #   #       # #     # #   #       #   # #
### ### ##### # # ##### # ##### ##### ##### # # # # ### ##### ###  E###
#######################################################################